NO ./textures/northwall.xpm
C 135,150,160
F 128,129,128





              WE                 ./textures/westwall.xpm

                        EA               ./textures/eastwall.xpm
SO              ./textures/southwall.xpm
111111111111111111111111111
10000000001 10000000000001
1011000001111000000000001
1001000000000000000100001
11111111110110N0001110001
10000000001100000111011111111
11110111111111011100000010001
1111011111111100001010010001
110000000101010000000010011
10000000000000000000000010111111111111111111111111111111111111
110000000000000001010010011
  11000011110010111101111001111
1100000001 111101 101111010001
100001111 1111111 111111111111
11111111111111111111111111111
